10.ox
.o....oooo
oo..o...oo
.o.o.o..oo
...o......
o.oo....o.
..oooo..oo
..o.o...o.
.o.oo.o..o
ooo..o..o.
o..o..oo.o
