20.ox
..o.....o..o.....o..
......o.....o....oo.
.....o..o.o.......o.
.o....o.............
..o...o............o
oo.o.oo...oo.....oo.
o.........o.......o.
....o.o.....o.......
o........o.o..o.o.o.
..o..o.............o
o......o.....o..o...
....oo......ooo...oo
..ooo.o...oo.o......
o.............o.....
......o...o.o.o...o.
........o.......oo.o
..o.....o....o...o..
..o.o.....oo...o...o
.o..........o.o...o.
..oo.o..o....o......
